AF|ğŸ‡¦ğŸ‡«|Afghanistan|Afghanistan
AX|ğŸ‡¦ğŸ‡½|Ã…land Islands|Aland Islands
AL|ğŸ‡¦ğŸ‡±|Albania|Albania
DZ|ğŸ‡©ğŸ‡¿|Algeria|Algeria
AS|ğŸ‡¦ğŸ‡¸|American Samoa|American Samoa
AD|ğŸ‡¦ğŸ‡©|Andorra|Andorra
AO|ğŸ‡¦ğŸ‡´|Angola|Angola
AI|ğŸ‡¦ğŸ‡®|Anguilla|Anguilla
AQ|ğŸ‡¦ğŸ‡¶|Antarctica|Antarctica
AG|ğŸ‡¦ğŸ‡¬|Antigua & Barbuda|Antigua & Barbuda
AR|ğŸ‡¦ğŸ‡·|Argentina|Argentina
AM|ğŸ‡¦ğŸ‡²|Armenia|Armenia
AW|ğŸ‡¦ğŸ‡¼|Aruba|Aruba
AU|ğŸ‡¦ğŸ‡º|Australia|Australia
AT|ğŸ‡¦ğŸ‡¹|Austria|Austria
AZ|ğŸ‡¦ğŸ‡¿|Azerbaijan|Azerbaijan
BS|ğŸ‡§ğŸ‡¸|Bahamas|Bahamas
BH|ğŸ‡§ğŸ‡­|Bahrain|Bahrain
BD|ğŸ‡§ğŸ‡©|Bangladesh|Bangladesh
BB|ğŸ‡§ğŸ‡§|Barbados|Barbados
BY|ğŸ‡§ğŸ‡¾|Belarus|Belarus
BE|ğŸ‡§ğŸ‡ª|Belgium|Belgium
BZ|ğŸ‡§ğŸ‡¿|Belize|Belize
BJ|ğŸ‡§ğŸ‡¯|Benin|Benin
BM|ğŸ‡§ğŸ‡²|Bermuda|Bermuda
BT|ğŸ‡§ğŸ‡¹|Bhutan|Bhutan
BO|ğŸ‡§ğŸ‡´|Bolivia|Bolivia
BA|ğŸ‡§ğŸ‡¦|Bosnia & Herzegovina|Bosnia & Herzegovina
BW|ğŸ‡§ğŸ‡¼|Botswana|Botswana
BV|ğŸ‡§ğŸ‡»|Bouvet Island|Bouvet Island
BR|ğŸ‡§ğŸ‡·|Brazil|Brazil
IO|ğŸ‡®ğŸ‡´|British Indian Ocean Territory|British Indian Ocean Territory
VG|ğŸ‡»ğŸ‡¬|British Virgin Islands|British Virgin Islands
BN|ğŸ‡§ğŸ‡³|Brunei|Brunei
BG|ğŸ‡§ğŸ‡¬|Bulgaria|Bulgaria
BF|ğŸ‡§ğŸ‡«|Burkina Faso|Burkina Faso
BI|ğŸ‡§ğŸ‡®|Burundi|Burundi
KH|ğŸ‡°ğŸ‡­|Cambodia|Cambodia
CM|ğŸ‡¨ğŸ‡²|Cameroon|Cameroon
CA|ğŸ‡¨ğŸ‡¦|Canada|Canada
CV|ğŸ‡¨ğŸ‡»|Cape Verde|Cape Verde
BQ|ğŸ‡§ğŸ‡¶|Caribbean Netherlands|Caribbean Netherlands
KY|ğŸ‡°ğŸ‡¾|Cayman Islands|Cayman Islands
CF|ğŸ‡¨ğŸ‡«|Central African Republic|Central African Republic
TD|ğŸ‡¹ğŸ‡©|Chad|Chad
CL|ğŸ‡¨ğŸ‡±|Chile|Chile
CN|ğŸ‡¨ğŸ‡³|China|China
CX|ğŸ‡¨ğŸ‡½|Christmas Island|Christmas Island
CC|ğŸ‡¨ğŸ‡¨|Cocos (Keeling) Islands|Cocos (Keeling) Islands
CO|ğŸ‡¨ğŸ‡´|Colombia|Colombia
KM|ğŸ‡°ğŸ‡²|Comoros|Comoros
CG|ğŸ‡¨ğŸ‡¬|Congo - Brazzaville|Congo - Brazzaville
CD|ğŸ‡¨ğŸ‡©|Congo - Kinshasa|Congo - Kinshasa
CK|ğŸ‡¨ğŸ‡°|Cook Islands|Cook Islands
CR|ğŸ‡¨ğŸ‡·|Costa Rica|Costa Rica
CI|ğŸ‡¨ğŸ‡®|CÃ´te dâ€™Ivoire|Cote dâ€™Ivoire
HR|ğŸ‡­ğŸ‡·|Croatia|Croatia
CU|ğŸ‡¨ğŸ‡º|Cuba|Cuba
CW|ğŸ‡¨ğŸ‡¼|CuraÃ§ao|Curacao
CY|ğŸ‡¨ğŸ‡¾|Cyprus|Cyprus
CZ|ğŸ‡¨ğŸ‡¿|Czechia|Czechia
DK|ğŸ‡©ğŸ‡°|Denmark|Denmark
DJ|ğŸ‡©ğŸ‡¯|Djibouti|Djibouti
DM|ğŸ‡©ğŸ‡²|Dominica|Dominica
DO|ğŸ‡©ğŸ‡´|Dominican Republic|Dominican Republic
EC|ğŸ‡ªğŸ‡¨|Ecuador|Ecuador
EG|ğŸ‡ªğŸ‡¬|Egypt|Egypt
SV|ğŸ‡¸ğŸ‡»|El Salvador|El Salvador
GQ|ğŸ‡¬ğŸ‡¶|Equatorial Guinea|Equatorial Guinea
ER|ğŸ‡ªğŸ‡·|Eritrea|Eritrea
EE|ğŸ‡ªğŸ‡ª|Estonia|Estonia
SZ|ğŸ‡¸ğŸ‡¿|Eswatini|Eswatini
ET|ğŸ‡ªğŸ‡¹|Ethiopia|Ethiopia
FK|ğŸ‡«ğŸ‡°|Falkland Islands|Falkland Islands
FO|ğŸ‡«ğŸ‡´|Faroe Islands|Faroe Islands
FJ|ğŸ‡«ğŸ‡¯|Fiji|Fiji
FI|ğŸ‡«ğŸ‡®|Finland|Finland
FR|ğŸ‡«ğŸ‡·|France|France
GF|ğŸ‡¬ğŸ‡«|French Guiana|French Guiana
PF|ğŸ‡µğŸ‡«|French Polynesia|French Polynesia
TF|ğŸ‡¹ğŸ‡«|French Southern Territories|French Southern Territories
GA|ğŸ‡¬ğŸ‡¦|Gabon|Gabon
GM|ğŸ‡¬ğŸ‡²|Gambia|Gambia
GE|ğŸ‡¬ğŸ‡ª|Georgia|Georgia
DE|ğŸ‡©ğŸ‡ª|Germany|Germany
GH|ğŸ‡¬ğŸ‡­|Ghana|Ghana
GI|ğŸ‡¬ğŸ‡®|Gibraltar|Gibraltar
GR|ğŸ‡¬ğŸ‡·|Greece|Greece
GL|ğŸ‡¬ğŸ‡±|Greenland|Greenland
GD|ğŸ‡¬ğŸ‡©|Grenada|Grenada
GP|ğŸ‡¬ğŸ‡µ|Guadeloupe|Guadeloupe
GU|ğŸ‡¬ğŸ‡º|Guam|Guam
GT|ğŸ‡¬ğŸ‡¹|Guatemala|Guatemala
GG|ğŸ‡¬ğŸ‡¬|Guernsey|Guernsey
GN|ğŸ‡¬ğŸ‡³|Guinea|Guinea
GW|ğŸ‡¬ğŸ‡¼|Guinea-Bissau|Guinea-Bissau
GY|ğŸ‡¬ğŸ‡¾|Guyana|Guyana
HT|ğŸ‡­ğŸ‡¹|Haiti|Haiti
HM|ğŸ‡­ğŸ‡²|Heard & McDonald Islands|Heard & McDonald Islands
HN|ğŸ‡­ğŸ‡³|Honduras|Honduras
HK|ğŸ‡­ğŸ‡°|Hong Kong SAR China|Hong Kong SAR China
HU|ğŸ‡­ğŸ‡º|Hungary|Hungary
IS|ğŸ‡®ğŸ‡¸|Iceland|Iceland
IN|ğŸ‡®ğŸ‡³|India|India
ID|ğŸ‡®ğŸ‡©|Indonesia|Indonesia
IR|ğŸ‡®ğŸ‡·|Iran|Iran
IQ|ğŸ‡®ğŸ‡¶|Iraq|Iraq
IE|ğŸ‡®ğŸ‡ª|Ireland|Ireland
IM|ğŸ‡®ğŸ‡²|Isle of Man|Isle of Man
IL|ğŸ‡®ğŸ‡±|Israel|Israel
IT|ğŸ‡®ğŸ‡¹|Italy|Italy
JM|ğŸ‡¯ğŸ‡²|Jamaica|Jamaica
JP|ğŸ‡¯ğŸ‡µ|Japan|Japan
JE|ğŸ‡¯ğŸ‡ª|Jersey|Jersey
JO|ğŸ‡¯ğŸ‡´|Jordan|Jordan
KZ|ğŸ‡°ğŸ‡¿|Kazakhstan|Kazakhstan
KE|ğŸ‡°ğŸ‡ª|Kenya|Kenya
KI|ğŸ‡°ğŸ‡®|Kiribati|Kiribati
KW|ğŸ‡°ğŸ‡¼|Kuwait|Kuwait
KG|ğŸ‡°ğŸ‡¬|Kyrgyzstan|Kyrgyzstan
LA|ğŸ‡±ğŸ‡¦|Laos|Laos
LV|ğŸ‡±ğŸ‡»|Latvia|Latvia
LB|ğŸ‡±ğŸ‡§|Lebanon|Lebanon
LS|ğŸ‡±ğŸ‡¸|Lesotho|Lesotho
LR|ğŸ‡±ğŸ‡·|Liberia|Liberia
LY|ğŸ‡±ğŸ‡¾|Libya|Libya
LI|ğŸ‡±ğŸ‡®|Liechtenstein|Liechtenstein
LT|ğŸ‡±ğŸ‡¹|Lithuania|Lithuania
LU|ğŸ‡±ğŸ‡º|Luxembourg|Luxembourg
MO|ğŸ‡²ğŸ‡´|Macao SAR China|Macao SAR China
MG|ğŸ‡²ğŸ‡¬|Madagascar|Madagascar
MW|ğŸ‡²ğŸ‡¼|Malawi|Malawi
MY|ğŸ‡²ğŸ‡¾|Malaysia|Malaysia
MV|ğŸ‡²ğŸ‡»|Maldives|Maldives
ML|ğŸ‡²ğŸ‡±|Mali|Mali
MT|ğŸ‡²ğŸ‡¹|Malta|Malta
MH|ğŸ‡²ğŸ‡­|Marshall Islands|Marshall Islands
MQ|ğŸ‡²ğŸ‡¶|Martinique|Martinique
MR|ğŸ‡²ğŸ‡·|Mauritania|Mauritania
MU|ğŸ‡²ğŸ‡º|Mauritius|Mauritius
YT|ğŸ‡¾ğŸ‡¹|Mayotte|Mayotte
MX|ğŸ‡²ğŸ‡½|Mexico|Mexico
FM|ğŸ‡«ğŸ‡²|Micronesia|Micronesia
MD|ğŸ‡²ğŸ‡©|Moldova|Moldova
MC|ğŸ‡²ğŸ‡¨|Monaco|Monaco
MN|ğŸ‡²ğŸ‡³|Mongolia|Mongolia
ME|ğŸ‡²ğŸ‡ª|Montenegro|Montenegro
MS|ğŸ‡²ğŸ‡¸|Montserrat|Montserrat
MA|ğŸ‡²ğŸ‡¦|Morocco|Morocco
MZ|ğŸ‡²ğŸ‡¿|Mozambique|Mozambique
MM|ğŸ‡²ğŸ‡²|Myanmar (Burma)|Myanmar (Burma)
NA|ğŸ‡³ğŸ‡¦|Namibia|Namibia
NR|ğŸ‡³ğŸ‡·|Nauru|Nauru
NP|ğŸ‡³ğŸ‡µ|Nepal|Nepal
NL|ğŸ‡³ğŸ‡±|Netherlands|Netherlands
NC|ğŸ‡³ğŸ‡¨|New Caledonia|New Caledonia
NZ|ğŸ‡³ğŸ‡¿|New Zealand|New Zealand
NI|ğŸ‡³ğŸ‡®|Nicaragua|Nicaragua
NE|ğŸ‡³ğŸ‡ª|Niger|Niger
NG|ğŸ‡³ğŸ‡¬|Nigeria|Nigeria
NU|ğŸ‡³ğŸ‡º|Niue|Niue
NF|ğŸ‡³ğŸ‡«|Norfolk Island|Norfolk Island
KP|ğŸ‡°ğŸ‡µ|North Korea|North Korea
MK|ğŸ‡²ğŸ‡°|North Macedonia|North Macedonia
MP|ğŸ‡²ğŸ‡µ|Northern Mariana Islands|Northern Mariana Islands
NO|ğŸ‡³ğŸ‡´|Norway|Norway
OM|ğŸ‡´ğŸ‡²|Oman|Oman
PK|ğŸ‡µğŸ‡°|Pakistan|Pakistan
PW|ğŸ‡µğŸ‡¼|Palau|Palau
PS|ğŸ‡µğŸ‡¸|Palestinian Territories|Palestinian Territories
PA|ğŸ‡µğŸ‡¦|Panama|Panama
PG|ğŸ‡µğŸ‡¬|Papua New Guinea|Papua New Guinea
PY|ğŸ‡µğŸ‡¾|Paraguay|Paraguay
PE|ğŸ‡µğŸ‡ª|Peru|Peru
PH|ğŸ‡µğŸ‡­|Philippines|Philippines
PN|ğŸ‡µğŸ‡³|Pitcairn Islands|Pitcairn Islands
PL|ğŸ‡µğŸ‡±|Poland|Poland
PT|ğŸ‡µğŸ‡¹|Portugal|Portugal
PR|ğŸ‡µğŸ‡·|Puerto Rico|Puerto Rico
QA|ğŸ‡¶ğŸ‡¦|Qatar|Qatar
RE|ğŸ‡·ğŸ‡ª|RÃ©union|Reunion
RO|ğŸ‡·ğŸ‡´|Romania|Romania
RU|ğŸ‡·ğŸ‡º|Russia|Russia
RW|ğŸ‡·ğŸ‡¼|Rwanda|Rwanda
WS|ğŸ‡¼ğŸ‡¸|Samoa|Samoa
SM|ğŸ‡¸ğŸ‡²|San Marino|San Marino
ST|ğŸ‡¸ğŸ‡¹|SÃ£o TomÃ© & PrÃ­ncipe|Sao Tome & Principe
SA|ğŸ‡¸ğŸ‡¦|Saudi Arabia|Saudi Arabia
SN|ğŸ‡¸ğŸ‡³|Senegal|Senegal
RS|ğŸ‡·ğŸ‡¸|Serbia|Serbia
SC|ğŸ‡¸ğŸ‡¨|Seychelles|Seychelles
SL|ğŸ‡¸ğŸ‡±|Sierra Leone|Sierra Leone
SG|ğŸ‡¸ğŸ‡¬|Singapore|Singapore
SX|ğŸ‡¸ğŸ‡½|Sint Maarten|Sint Maarten
SK|ğŸ‡¸ğŸ‡°|Slovakia|Slovakia
SI|ğŸ‡¸ğŸ‡®|Slovenia|Slovenia
SB|ğŸ‡¸ğŸ‡§|Solomon Islands|Solomon Islands
SO|ğŸ‡¸ğŸ‡´|Somalia|Somalia
ZA|ğŸ‡¿ğŸ‡¦|South Africa|South Africa
GS|ğŸ‡¬ğŸ‡¸|South Georgia & South Sandwich Islands|South Georgia & South Sandwich Islands
KR|ğŸ‡°ğŸ‡·|South Korea|South Korea
SS|ğŸ‡¸ğŸ‡¸|South Sudan|South Sudan
ES|ğŸ‡ªğŸ‡¸|Spain|Spain
LK|ğŸ‡±ğŸ‡°|Sri Lanka|Sri Lanka
BL|ğŸ‡§ğŸ‡±|St. BarthÃ©lemy|St. Barthelemy
SH|ğŸ‡¸ğŸ‡­|St. Helena|St. Helena
KN|ğŸ‡°ğŸ‡³|St. Kitts & Nevis|St. Kitts & Nevis
LC|ğŸ‡±ğŸ‡¨|St. Lucia|St. Lucia
MF|ğŸ‡²ğŸ‡«|St. Martin|St. Martin
PM|ğŸ‡µğŸ‡²|St. Pierre & Miquelon|St. Pierre & Miquelon
VC|ğŸ‡»ğŸ‡¨|St. Vincent & Grenadines|St. Vincent & Grenadines
SD|ğŸ‡¸ğŸ‡©|Sudan|Sudan
SR|ğŸ‡¸ğŸ‡·|Suriname|Suriname
SJ|ğŸ‡¸ğŸ‡¯|Svalbard & Jan Mayen|Svalbard & Jan Mayen
SE|ğŸ‡¸ğŸ‡ª|Sweden|Sweden
CH|ğŸ‡¨ğŸ‡­|Switzerland|Switzerland
SY|ğŸ‡¸ğŸ‡¾|Syria|Syria
TW|ğŸ‡¹ğŸ‡¼|Taiwan|Taiwan
TJ|ğŸ‡¹ğŸ‡¯|Tajikistan|Tajikistan
TZ|ğŸ‡¹ğŸ‡¿|Tanzania|Tanzania
TH|ğŸ‡¹ğŸ‡­|Thailand|Thailand
TL|ğŸ‡¹ğŸ‡±|Timor-Leste|Timor-Leste
TG|ğŸ‡¹ğŸ‡¬|Togo|Togo
TK|ğŸ‡¹ğŸ‡°|Tokelau|Tokelau
TO|ğŸ‡¹ğŸ‡´|Tonga|Tonga
TT|ğŸ‡¹ğŸ‡¹|Trinidad & Tobago|Trinidad & Tobago
TN|ğŸ‡¹ğŸ‡³|Tunisia|Tunisia
TR|ğŸ‡¹ğŸ‡·|Turkey|Turkey
TM|ğŸ‡¹ğŸ‡²|Turkmenistan|Turkmenistan
TC|ğŸ‡¹ğŸ‡¨|Turks & Caicos Islands|Turks & Caicos Islands
TV|ğŸ‡¹ğŸ‡»|Tuvalu|Tuvalu
UM|ğŸ‡ºğŸ‡²|U.S. Outlying Islands|U.S. Outlying Islands
VI|ğŸ‡»ğŸ‡®|U.S. Virgin Islands|U.S. Virgin Islands
UG|ğŸ‡ºğŸ‡¬|Uganda|Uganda
UA|ğŸ‡ºğŸ‡¦|Ukraine|Ukraine
AE|ğŸ‡¦ğŸ‡ª|United Arab Emirates|United Arab Emirates
GB|ğŸ‡¬ğŸ‡§|United Kingdom|United Kingdom
US|ğŸ‡ºğŸ‡¸|United States|United States
UY|ğŸ‡ºğŸ‡¾|Uruguay|Uruguay
UZ|ğŸ‡ºğŸ‡¿|Uzbekistan|Uzbekistan
VU|ğŸ‡»ğŸ‡º|Vanuatu|Vanuatu
VA|ğŸ‡»ğŸ‡¦|Vatican City|Vatican City
VE|ğŸ‡»ğŸ‡ª|Venezuela|Venezuela
VN|ğŸ‡»ğŸ‡³|Vietnam|Vietnam
WF|ğŸ‡¼ğŸ‡«|Wallis & Futuna|Wallis & Futuna
EH|ğŸ‡ªğŸ‡­|Western Sahara|Western Sahara
YE|ğŸ‡¾ğŸ‡ª|Yemen|Yemen
ZM|ğŸ‡¿ğŸ‡²|Zambia|Zambia
ZW|ğŸ‡¿ğŸ‡¼|Zimbabwe|Zimbabwe
